4444444444
4444004444
4443230444
4000000204
4000000004
4033004044
4440044444
4442244444
4440104444
4444444444

4444444444
4444400004
4444402004
4444020034
4444000444
4404030404
4020000004
4000203314
4000000004
4444444444

4444444444
4400044044
4000330214
4402000204
4440044444
4440004444
4304044444
4244004444
4000304444
4444444444

4444444444
4104444444
4020440004
4400440044
4004444044
4230440004
4000440244
4320440004
4000003304
4444444444


4444444444
4304000044
4000222144
4304002444
4044440044
4300000044
4344044444
4044444444
4044444444
4444444444