##########
####  ####
###.$. ###
#      $ #
#        #
# ..  # ##
###  #####
###$$#####
### @ ####
##########

##########
#####    #
##### $  #
#### $  .#
####   ###
## # . # #
# $      #
#   $ ..@#
#        #
##########

##########
##   ## ##
#   .. $@#
## $   $ #
###  #####
###   ####
#. # #####
#$##  ####
#   . ####
##########

##########
#@ #######
# $ ##   #
##  ##  ##
#  #### ##
#$. ##   #
#   ## $##
#.$ ##   #
#     .. #
##########


##########
#. #    ##
#   $$$@##
#. #  $###
# ####  ##
#.      ##
#.## #####
# ########
# ########
##########