##########
####     #
#### $ $ #
#####@ ###
###.# ####
# $   ####
# .    ###
#  # $.###
# ## .####
##########

##########
####  ####
# # $    #
#   #.$$ #
# $##.#  #
# .#  ## #
# ##  ## #
#  ##  ###
#   @ .###
##########

##########
# ###### #
# ###### #
#  #### .#
# #####  #
#.$ ## . #
## $@$   #
##.  #$  #
######   #
##########

##########
#   ######
#   .#####
# $ # ####
#  .  . ##
# #   $###
#####.   #
#####$ $ #
#   @    #
##########

##########
#  #######
#  #######
# $  $ ###
# ... $@##
#  ##$ ###
# ###   ##
#.####   #
#  ###  ##
##########